s.......
..#..#..
........
........
..#..#..
........